bvn,account_number,date,description,deposits,withdrawals,balance
38612218715,1004605806,2017-05-09 00:00:00,Opening Balance,0.00,0.00,349316.96
38612218715,1004605806,2017-05-09 10:24:00,NIP Charge + VAT,0.00,105.00,349211.96
38612218715,1004605806,2017-05-09 10:26:00,NIP Charge + VAT,0.00,105.00,349106.96
38612218715,1004605806,2017-05-09 10:26:00,NIP CR/MOSES ASHIBI/STBC,0.00,5000.00,344106.96
38612218715,1004605806,2017-05-09 10:28:00,Airtime//09031904969//MTN,0.00,10000.00,334106.96
38612218716,1004605807,2017-05-09 10:24:00,NIP CR/PETERS GBENGA MICHAEL/ECO,0.00,20000.00,314106.96
38612218717,1004605808,2017-05-29 03:26:00,SMS Notification Charge May 2017,0.00,16.00,314090.96
38612218718,1004605809,2017-05-31 23:07:00,Acct Maint. Fee + VAT,0.00,36.75,314054.21